gggggggggggggggggggg
g..................g
g..................g
g..................g
g..................g
g..................g
g..................g
g.....g......g.....g
g.....g......g.....g
g..................g
g...g..........g...g
g...g..........g...g
g....g........g....g
g.....gggggggg.....g
g..................g
g..................g
g..................g
g..................g
g..................g
gggggggggggggggggggg
